60 40
59 59 59 59 59 59 59 59 59 59 59 59 59 59 59 59 59 59 103 104 105 59 18 16 16 16 16 16 16 16 16 16 16 16 19 59 59 59 59 59 59 100 59 59 59 59 383 59 59 59 59 59 59 59 59 59 59 59 59 59
59 59 59 59 59 59 350 351 102 59 59 357 358 359 59 59 66 59 103 104 105 59 26 80 72 70 72 59 59 59 71 81 71 71 26 67 59 357 358 359 59 59 59 67 59 393 147 394 59 100 59 59 403 160 161 161 161 162 404 59
59 59 101 59 59 59 360 361 59 59 59 367 368 369 59 59 59 59 103 120 105 59 26 70 80 70 59 59 59 59 59 71 81 81 26 59 59 367 368 369 59 59 101 59 393 156 147 158 394 59 59 59 123 180 181 181 181 182 125 59
59 59 59 59 102 59 370 371 59 59 59 377 378 379 59 102 59 59 103 104 105 59 26 80 70 59 59 59 101 59 59 59 81 71 26 101 59 377 378 379 59 79 59 393 156 156 147 158 158 394 59 79 123 170 171 171 171 172 125 59
59 59 59 59 59 59 375 376 59 101 59 59 39 59 59 100 59 87 103 104 105 59 26 59 59 59 59 59 59 59 59 59 59 59 25 59 59 59 39 59 59 59 59 156 156 156 146 158 158 158 59 59 133 134 134 134 134 134 135 59
59 59 59 59 59 59 57 58 59 59 59 59 59 59 59 59 59 59 103 104 105 59 26 52 59 59 59 59 59 59 59 59 59 59 59 59 59 59 59 59 357 358 359 156 156 166 159 168 158 158 59 59 163 164 164 164 164 164 165 59
59 102 59 59 59 59 59 87 59 59 59 59 59 101 59 59 59 102 103 121 105 100 26 62 52 59 59 59 59 59 59 50 51 51 27 59 10 11 12 59 367 368 369 156 166 148 153 149 168 158 59 72 173 174 78 174 153 153 175 59
59 77 59 59 101 59 59 59 59 100 102 59 59 68 59 59 59 59 103 104 105 59 26 62 52 60 59 59 59 59 51 50 51 50 26 59 20 21 22 59 377 378 379 166 148 127 127 127 149 168 59 70 183 184 88 184 184 184 185 59
59 59 59 59 59 59 59 59 59 59 59 59 59 59 59 59 59 59 103 120 105 59 28 16 16 16 16 16 16 16 16 16 16 16 29 59 20 21 22 59 59 39 59 116 117 117 117 117 117 118 59 59 59 59 59 80 352 353 354 59
59 59 59 59 102 59 59 101 59 59 59 59 59 59 59 101 59 59 103 104 105 59 59 59 59 59 59 87 59 59 59 59 99 59 59 59 20 21 22 59 59 59 100 126 153 127 78 127 153 128 69 59 59 10 11 12 362 363 364 59
59 100 352 353 354 59 59 59 59 59 59 59 59 100 59 59 59 59 103 104 107 94 94 94 94 94 94 94 94 94 94 94 94 94 95 77 20 21 23 11 11 12 59 136 137 137 88 137 137 138 59 10 11 24 21 22 372 373 374 59
59 59 362 363 364 59 100 59 59 59 59 59 77 59 59 59 79 59 103 104 104 122 104 120 104 104 104 104 121 104 104 104 122 104 105 59 20 21 21 21 21 22 59 26 111 100 59 102 112 26 59 20 21 21 21 22 47 48 49 59
102 59 372 373 374 59 59 68 59 59 102 59 59 59 59 59 59 59 113 114 114 114 114 114 114 114 114 114 114 114 114 114 98 104 105 59 30 31 31 14 21 22 59 26 110 101 59 100 111 26 59 30 31 31 31 32 59 59 59 59
59 59 47 48 49 59 59 59 59 59 59 59 59 59 59 102 59 59 100 59 59 102 76 59 59 59 59 59 59 59 59 384 103 104 105 59 99 59 59 20 21 22 59 26 112 102 59 101 110 26 59 59 403 160 161 161 161 162 404 59
59 59 59 59 59 59 102 59 59 59 59 59 59 59 59 59 59 59 59 59 59 59 59 59 59 101 59 79 102 59 59 86 103 104 105 357 358 359 59 20 21 22 59 28 16 17 59 15 16 29 59 59 123 180 181 181 181 182 125 59
59 59 10 11 11 11 11 11 11 11 11 11 11 11 11 11 11 11 11 11 11 11 11 11 12 59 59 59 67 357 358 359 103 104 105 367 368 369 59 20 21 22 59 59 59 10 11 12 62 52 101 59 123 170 171 171 171 172 125 59
59 101 20 44 44 44 44 44 44 44 44 44 44 44 44 44 44 44 44 44 44 44 44 44 22 59 59 100 59 367 368 369 103 104 105 377 378 379 59 20 21 22 59 59 100 20 21 22 59 59 59 59 133 134 134 134 134 134 135 59
59 59 20 44 44 44 44 44 44 44 44 91 44 44 44 44 44 44 44 44 92 44 44 91 22 59 102 59 59 377 378 379 103 120 105 59 39 59 100 20 21 22 99 209 59 20 21 22 59 59 59 69 130 131 131 131 131 131 132 59
87 59 20 44 44 44 44 44 44 44 44 44 44 44 90 44 44 44 44 44 44 44 44 44 22 59 59 59 59 59 39 59 103 104 105 87 59 59 59 20 21 22 59 59 59 20 21 22 59 59 59 81 140 153 141 78 141 153 142 59
59 59 20 44 44 44 33 34 34 34 34 34 34 34 34 34 34 34 34 34 34 35 44 44 23 11 11 11 11 11 12 59 40 41 42 10 11 11 11 24 21 23 11 11 11 24 21 23 11 11 12 71 150 151 151 88 151 151 152 59
100 59 20 44 91 44 43 44 44 44 44 44 92 44 44 44 44 44 44 44 44 45 44 44 44 44 92 44 44 44 22 59 330 331 332 20 21 21 21 21 21 21 21 21 21 21 21 21 21 21 22 59 26 111 59 59 69 112 26 67
59 59 20 44 44 44 43 44 44 44 44 44 44 44 44 91 44 44 44 44 44 45 44 44 13 31 31 31 31 31 32 59 340 341 342 30 31 31 31 31 31 31 31 31 31 31 31 31 14 21 22 100 26 112 59 59 69 110 26 59
59 101 20 44 44 44 43 92 44 44 33 34 34 34 34 34 35 44 44 90 44 45 91 44 22 59 102 59 59 59 59 59 103 104 105 59 100 59 59 59 59 59 59 59 59 59 59 59 20 21 22 59 26 110 59 59 69 111 26 59
59 59 20 44 92 44 43 44 44 90 43 44 44 91 44 44 45 44 44 44 44 45 44 44 22 59 59 59 59 59 59 59 103 104 105 59 59 59 384 59 101 59 100 59 59 89 59 59 20 21 22 59 26 110 59 59 69 112 26 59
59 59 20 44 33 34 250 44 44 44 43 44 44 44 44 44 45 44 44 44 92 45 44 44 22 59 59 59 59 59 102 59 103 104 105 59 59 87 86 59 59 59 59 59 59 59 101 59 30 31 32 59 28 16 17 59 15 16 29 59
59 102 20 44 43 44 44 44 44 44 43 44 44 44 44 92 45 44 44 44 44 45 44 44 22 59 59 101 59 59 59 59 103 121 107 94 94 94 94 94 94 94 94 94 94 95 59 59 352 353 354 59 59 59 101 59 59 59 59 59
59 59 20 44 43 44 44 91 44 44 53 54 54 54 36 54 55 44 91 44 44 45 44 44 22 59 59 59 59 59 89 59 103 104 104 104 104 104 120 104 122 104 104 104 104 105 59 59 362 363 364 59 59 59 59 59 59 100 59 59
59 68 20 44 43 92 44 44 44 44 63 64 64 64 46 64 65 44 44 44 44 45 44 44 22 59 59 59 59 59 59 59 113 114 114 114 114 114 114 114 114 114 114 98 104 105 100 59 372 373 374 59 355 356 59 59 59 59 59 59
100 59 20 90 43 44 44 44 44 44 73 74 74 74 56 74 75 44 44 261 54 55 44 90 22 59 59 102 59 100 59 59 59 59 59 59 59 59 59 59 77 59 384 103 104 105 87 59 47 48 49 59 365 366 59 384 384 59 384 59
59 59 20 44 43 44 91 44 44 44 44 92 44 44 44 90 44 44 44 271 64 65 44 44 22 59 59 59 59 59 59 59 101 59 59 59 59 59 59 59 59 59 86 103 121 105 59 59 59 59 59 59 37 38 59 86 86 59 86 59
59 59 20 44 43 44 44 44 44 44 44 44 44 44 44 44 44 44 44 281 74 75 44 91 22 59 59 355 356 59 59 59 59 59 59 59 357 358 359 59 59 101 59 103 104 107 94 94 94 94 94 94 94 94 94 94 94 94 94 94
59 87 20 44 53 54 54 54 36 54 54 54 54 252 253 54 54 54 54 55 92 44 44 44 22 59 59 365 366 59 59 59 59 59 59 59 367 368 369 59 99 59 59 103 122 104 104 104 104 120 104 104 104 121 104 104 104 120 104 104
59 59 20 44 63 64 64 64 46 64 64 64 64 262 263 64 64 64 64 65 44 44 44 44 22 67 59 37 38 59 102 59 59 59 59 59 377 378 379 59 59 59 59 103 104 97 114 114 114 114 114 114 114 114 114 114 114 114 114 114
59 59 20 44 73 74 74 74 56 74 74 74 74 272 273 74 74 74 74 75 44 44 90 44 22 59 59 59 59 59 59 59 59 59 59 59 59 39 59 59 59 59 59 103 104 105 59 59 59 59 59 59 59 384 384 59 59 384 59 59
102 59 20 44 44 44 92 44 44 90 44 44 44 44 44 44 91 44 44 44 44 44 44 44 22 59 59 59 59 59 59 100 59 87 59 59 59 59 59 59 357 358 359 40 41 42 59 59 59 59 59 59 59 86 86 59 99 86 59 59
59 59 20 44 91 44 44 44 44 44 44 44 44 92 44 44 44 44 44 44 44 91 44 44 22 59 350 351 59 59 59 59 59 59 59 59 89 59 59 59 367 368 369 330 331 332 59 101 59 87 59 59 59 100 59 59 59 59 59 59
59 59 30 31 31 31 31 31 31 31 31 31 31 31 31 31 31 31 31 31 31 31 31 31 32 59 360 361 102 59 355 356 59 59 102 59 59 59 59 100 377 378 379 340 341 342 59 59 68 59 59 59 59 59 59 59 101 59 59 59
59 100 59 59 102 102 59 59 59 59 59 59 59 100 59 59 59 59 59 59 102 59 59 59 59 59 370 371 59 59 365 366 59 59 59 59 59 59 59 59 59 39 59 103 121 105 59 385 59 59 59 101 59 59 59 59 385 59 59 59
59 59 59 59 59 59 77 102 59 59 102 59 59 59 59 68 59 67 59 59 59 59 59 59 59 102 375 376 59 59 37 38 59 59 59 59 59 59 59 59 59 59 59 103 104 105 59 189 100 59 199 59 59 199 69 59 189 59 59 59
59 59 59 59 59 59 59 59 59 59 59 59 59 59 59 59 102 59 100 59 59 59 87 59 59 59 37 38 100 59 59 102 59 59 59 59 59 100 59 59 59 59 59 103 104 105 59 59 59 59 59 59 59 59 59 59 59 59 59 59
